0 0 0 0 0 0 0 0 0 0 0 0 0 0 0 0 0 0 0 0 0 0 0 0 0 0 0 0 0 0 0 0 0 0 0 0 0 0 0 0 0 0 0 0 0 0 0 0 0 0 0 0 0 0 0 0 0 0 0 0 0 0 0 0 0 0 0 0 0 0 0 0 0 0 0
0 1 1 1 1 1 1 1 1 1 1 1 1 1 1 1 1 1 1 1 1 1 1 1 1 1 1 1 1 1 1 1 1 1 1 1 1 1 1 1 1 1 1 1 1 1 1 1 1 1 1 1 1 1 1 1 1 1 1 1 1 1 1 1 1 1 1 1 1 1 1 1 1 1 0
0 1 0 0 0 0 0 0 0 0 0 0 0 0 0 0 0 0 0 0 0 0 0 0 0 0 0 0 0 0 0 0 0 0 0 0 0 0 0 0 0 0 0 0 0 0 0 0 0 0 0 0 0 0 0 0 0 0 0 0 0 0 0 0 0 0 0 0 0 0 0 0 0 1 0
0 1 0 T R R R R R R R R R R R R R R R R R R R R T R R R R R R R R R R R R R R R R R R R R R R R T R R R R R R R R R R R R R R R R R R R R T 1 1 0 1 0
0 1 0 R W 1 1 P 1 1 P 1 1 P 1 1 P 1 1 P 1 1 P 1 R P 1 1 P 1 1 P 1 1 P 1 1 P 1 1 P 1 1 P 1 1 P 1 R P 1 1 P 1 1 P 1 1 P 1 1 P 1 1 P 1 1 P 1 R W 1 0 1 0
0 1 0 R 1 1 1 1 1 1 1 1 1 1 1 1 1 1 1 1 1 1 1 1 R 1 1 1 1 1 1 1 1 1 1 1 1 1 1 1 1 1 1 1 1 1 1 1 R 1 1 1 1 1 1 1 1 1 1 1 1 1 1 1 1 1 1 1 1 R 1 1 0 1 0
0 1 0 R 1 1 0 0 0 0 0 0 0 0 0 0 0 0 0 0 0 0 0 0 R 1 1 0 0 0 0 0 0 0 0 0 0 0 0 0 0 0 0 0 0 0 0 0 R 1 1 0 0 0 0 0 0 0 0 0 0 0 0 0 0 0 0 0 0 R 1 1 0 1 0
0 1 0 R P 1 0 1 1 1 1 1 1 1 1 1 1 1 1 1 1 1 1 0 R P 1 0 1 1 1 1 1 1 1 1 1 1 1 1 1 1 1 1 1 1 1 0 R P 1 0 1 1 1 1 1 1 1 1 1 1 1 1 1 1 1 1 0 R P 1 0 1 0
0 1 0 R 1 1 0 0 0 0 0 0 0 0 0 0 0 0 0 1 0 0 0 0 R 1 1 0 0 0 0 0 0 0 0 0 0 1 0 0 0 0 0 0 0 0 0 0 R 1 1 0 0 0 0 1 0 0 0 0 0 0 0 0 0 0 0 0 0 R 1 1 0 1 0
0 1 0 T R R R R R R R R R R R T 1 1 0 1 0 T R R T R R R R R R R R T 1 1 0 1 0 T R R R R R R R R T R R T 1 1 0 1 0 T R R R R R R R R R R R T 1 1 0 1 0
0 1 0 R P 1 1 P 1 1 P 1 1 P 1 R P 1 0 1 0 R P 1 1 P 1 1 P 1 1 P 1 R P 1 0 1 0 R P 1 1 P 1 1 P 1 1 P 1 R P 1 0 1 0 R P 1 1 P 1 1 P 1 1 P 1 R P 1 0 1 0
0 1 0 R 1 1 1 1 1 1 1 1 1 1 1 R 1 1 0 1 0 R 1 1 1 1 1 1 1 1 1 1 1 R 1 1 0 1 0 R 1 1 1 1 1 1 1 1 1 1 1 R 1 1 0 1 0 R 1 1 1 1 1 1 1 1 1 1 1 R 1 1 0 1 0
0 1 0 R 1 1 0 0 0 0 0 0 0 0 0 R 1 1 0 1 0 R 1 1 0 0 0 0 0 0 0 0 0 R 1 1 0 1 0 R 1 1 0 0 0 0 0 0 0 0 0 R 1 1 0 1 0 R 1 1 0 0 0 0 0 0 0 0 0 R 1 1 0 1 0
0 1 0 R P 1 0 1 1 1 1 1 1 1 0 R P 1 0 1 0 R P 1 0 1 1 1 1 1 1 1 0 R P 1 0 1 0 R P 1 0 1 1 1 1 1 1 1 0 R P 1 0 1 0 R P 1 0 1 1 1 1 1 1 1 0 R P 1 0 1 0
0 1 0 R 1 1 0 0 0 0 0 0 0 1 0 R 1 1 0 1 0 R 1 1 0 1 1 1 1 1 1 1 0 R 1 1 0 1 0 R 1 1 0 1 1 1 1 1 1 1 0 R 1 1 0 1 0 R 1 1 0 1 0 0 0 0 0 0 0 R 1 1 0 1 0
0 1 0 T R R R R R T 1 1 0 1 0 R 1 1 0 1 0 R 1 1 0 1 1 1 1 1 1 1 0 R 1 1 0 1 0 R 1 1 0 1 1 1 1 1 1 1 0 R 1 1 0 1 0 R 1 1 0 1 0 T R R R R R T 1 1 0 1 0
0 1 0 R P 1 1 P 1 R P 1 0 1 0 R P 1 0 1 0 R P 1 0 1 1 1 1 1 1 1 0 R P 1 0 1 0 R P 1 0 1 1 1 1 1 1 1 0 R P 1 0 1 0 R P 1 0 1 0 R P 1 1 P 1 R P 1 0 1 0
0 1 0 R 1 1 1 1 1 R 1 1 0 0 0 R 1 1 0 1 0 R 1 1 0 1 0 0 0 0 0 0 0 R 1 1 0 0 0 R 1 1 0 0 0 0 0 0 0 1 0 R 1 1 0 1 0 R 1 1 0 0 0 R 1 1 1 1 1 R 1 1 0 1 0
0 1 0 R 1 1 0 0 0 T R R R R R T 1 1 0 1 0 R 1 1 0 1 0 T R R R R R T R R T R R T R R R R R T 1 1 0 1 0 R 1 1 0 1 0 T R R R R R T 1 1 0 0 0 R 1 1 0 1 0
0 1 0 R P 1 0 1 0 R P 1 1 P 1 R P 1 0 1 0 R P 1 0 1 0 R P 1 1 P 1 1 P 1 R W 1 1 P 1 1 P 1 R P 1 0 1 0 R P 1 0 1 0 R P 1 1 P 1 R P 1 0 1 0 R P 1 0 1 0
0 1 0 R 1 1 0 1 0 R 1 1 1 1 1 R 1 1 0 0 0 R 1 1 0 1 0 R 1 1 1 1 1 1 1 1 R 1 1 1 1 1 1 1 1 R 1 1 0 1 0 R 1 1 0 0 0 R 1 1 1 1 1 R 1 1 0 1 0 R 1 1 0 1 0
0 1 0 R 1 1 0 1 0 R 1 1 0 0 0 T R R R R R T 1 1 0 1 0 R 1 1 0 0 0 0 0 0 R 1 1 0 0 0 0 0 0 R 1 1 0 1 0 T R R R R R T 1 1 0 0 0 R 1 1 0 1 0 R 1 1 0 1 0
0 1 0 R P 1 0 1 0 R P 1 0 1 0 1 P 1 1 P 1 R P 1 0 1 0 R P 1 0 1 1 1 1 0 R P 1 0 1 1 1 1 0 R P 1 0 1 0 R P 1 1 P 1 1 P 1 0 1 0 R P 1 0 1 0 R P 1 0 1 0
0 1 0 R 1 1 0 1 0 R 1 1 0 1 0 1 1 1 1 1 1 R 1 1 0 0 0 R 1 1 0 1 1 1 1 0 R 1 1 0 1 1 1 1 0 R 1 1 0 0 0 R 1 1 1 1 1 1 1 1 0 1 0 R 1 1 0 1 0 R 1 1 0 1 0
0 1 0 R 1 1 0 1 0 R 1 1 0 1 0 0 0 0 0 0 0 T R R R R R T 1 1 0 1 1 1 1 0 R 1 1 0 1 1 1 1 0 T R R R R R T 1 1 0 0 0 0 0 0 0 1 0 R 1 1 0 1 0 R 1 1 0 1 0
0 1 0 R P 1 0 1 0 R P 1 0 1 1 1 1 1 1 1 0 R P 1 1 P 1 R P 1 0 1 1 1 1 0 R P 1 0 1 1 1 1 0 R P 1 1 P 1 R P 1 0 1 1 1 1 1 1 1 0 R P 1 0 1 0 R P 1 0 1 0
0 1 0 R 1 1 0 1 0 R 1 1 0 0 0 0 0 0 0 0 0 R 1 1 1 1 1 R 1 1 0 1 1 1 1 0 R 1 1 0 1 1 1 1 0 R 1 1 1 1 1 R 1 1 0 0 0 0 0 0 0 0 0 R 1 1 0 1 0 R 1 1 0 1 0
0 1 0 R 1 1 0 1 0 T R R R R R R R R R R R T 1 1 0 0 0 R 1 1 0 1 1 1 1 0 R 1 1 0 1 1 1 1 0 R 1 1 0 0 0 T R R R R R R R R R R R T 1 1 0 1 0 R 1 1 0 1 0
0 1 0 R P 1 0 1 0 1 P 1 1 P 1 1 P 1 1 P 1 R P 1 0 1 0 R P 1 0 1 1 1 1 0 R P 1 0 1 1 1 1 0 R P 1 0 1 0 R P 1 1 P 1 1 P 1 1 P 1 1 P 1 0 1 0 R P 1 0 1 0
0 1 0 R 1 1 0 1 0 1 1 1 1 1 1 1 1 1 1 1 1 R 1 1 0 1 0 R 1 1 0 0 0 0 0 0 R 1 1 0 0 0 0 0 0 R 1 1 0 1 0 R 1 1 1 1 1 1 1 1 1 1 1 1 1 1 0 1 0 R 1 1 0 1 0
0 1 0 R 1 1 0 1 0 0 0 0 0 0 0 0 0 0 0 0 0 R 1 1 0 1 0 T R R R R R R R R T R R R R R R R R T 1 1 0 1 0 R 1 1 0 0 0 0 0 0 0 0 0 0 0 0 0 1 0 R 1 1 0 1 0
0 1 0 R P 1 0 1 1 1 1 1 1 1 1 1 1 1 1 1 0 R P 1 0 1 0 R 1 1 1 1 1 1 1 1 O 1 1 1 1 1 1 1 1 R 1 1 0 1 0 R P 1 0 1 1 1 1 1 1 1 1 1 1 1 1 1 0 R P 1 0 1 0
0 1 0 R 1 1 0 0 0 0 0 0 0 0 0 0 0 0 0 0 0 R 1 1 0 1 0 R 1 1 1 1 1 1 1 1 O 1 1 1 1 1 1 1 1 R 1 1 0 1 0 R 1 1 0 0 0 0 0 0 0 0 0 0 0 0 0 0 0 R 1 1 0 1 0
0 1 0 T R R R R R R R R T R R R R R R R R T 1 1 0 1 0 R 1 1 0 0 0 0 0 0 O 1 1 0 0 0 0 0 0 R 1 1 0 1 0 T R R R R R R R R T R R R R R R R R T 1 1 0 1 0
0 1 0 1 P 1 1 P 1 1 P 1 R P 1 1 P 1 1 P 1 1 P 1 0 1 0 R 1 1 0 1 1 1 1 0 O 1 1 0 1 1 1 1 0 R 1 1 0 1 0 1 P 1 1 P 1 1 P 1 R P 1 1 P 1 1 P 1 1 P 1 0 1 0
0 1 0 1 1 1 1 1 1 1 1 1 R 1 1 1 1 1 1 1 1 1 1 1 0 1 0 R 1 1 0 1 0 0 0 0 O 1 1 0 0 0 0 1 0 R 1 1 0 1 0 1 1 1 1 1 1 1 1 1 R 1 1 1 1 1 1 1 1 1 1 1 0 1 0
0 1 0 0 0 0 0 0 0 0 0 0 R 1 1 0 0 0 0 0 0 0 0 0 0 1 0 R 1 1 0 1 0 T O O T O O T 1 1 0 1 0 R 1 1 0 1 0 0 0 0 0 0 0 0 0 0 R 1 1 0 0 0 0 0 0 0 0 0 0 1 0
0 1 1 1 1 1 1 1 1 1 1 0 R W 1 0 1 1 1 1 1 1 1 1 1 1 0 R 1 1 0 1 0 1 1 1 1 1 1 1 1 1 0 1 0 R 1 1 0 1 1 1 1 1 1 1 1 1 1 0 R W 1 0 1 1 1 1 1 1 1 1 1 1 0
0 1 0 0 0 0 0 0 0 0 0 0 R 1 1 0 0 0 0 0 0 0 0 0 0 1 0 R 1 1 0 1 0 1 1 G 1 1 1 1 1 1 0 1 0 R 1 1 0 1 0 0 0 0 0 0 0 0 0 0 R 1 1 0 0 0 0 0 0 0 0 0 0 1 0
0 1 0 T R R R R R R R R T R R R R R R R R T 1 1 0 1 0 R 1 1 0 1 0 0 0 0 0 0 0 0 0 0 0 1 0 R 1 1 0 1 0 T R R R R R R R R T R R R R R R R R T 1 1 0 1 0
0 1 0 R P 1 1 P 1 1 P 1 1 P 1 1 P 1 1 P 1 R P 1 0 1 0 R 1 1 0 1 1 1 1 1 1 1 1 1 1 1 1 1 0 R 1 1 0 1 0 R P 1 1 P 1 1 P 1 1 P 1 1 P 1 1 P 1 R P 1 0 1 0
0 1 0 R 1 1 1 1 1 1 1 1 1 1 1 1 1 1 1 1 1 R 1 1 0 1 0 R 1 1 0 0 0 0 0 0 0 0 0 0 0 0 0 0 0 R 1 1 0 1 0 R 1 1 1 1 1 1 1 1 1 1 1 1 1 1 1 1 1 R 1 1 0 1 0
0 1 0 R 1 1 0 0 0 0 0 0 0 0 0 0 0 0 0 0 0 R 1 1 0 1 0 T R R R R R R R R T R R R R R R R R T 1 1 0 1 0 R 1 1 0 0 0 0 0 0 0 0 0 0 0 0 0 0 0 R 1 1 0 1 0
0 1 0 R P 1 0 1 1 1 1 1 1 1 1 1 1 1 1 1 0 R P 1 0 1 0 R 1 1 1 1 1 1 1 1 R 1 1 1 1 1 1 1 1 R 1 1 0 1 0 R P 1 0 1 1 1 1 1 1 1 1 1 1 1 1 1 0 R P 1 0 1 0
0 1 0 R 1 1 0 0 0 0 0 0 0 0 0 0 0 0 0 1 0 R 1 1 0 1 0 R 1 1 1 1 1 1 1 1 R 1 S 1 1 1 1 1 1 R 1 1 0 1 0 R 1 1 0 1 0 0 0 0 0 0 0 0 0 0 0 0 0 R 1 1 0 1 0
0 1 0 T R R R R R R R R R R R T 1 1 0 1 0 R 1 1 0 1 0 R 1 1 0 0 0 0 0 0 R 1 1 0 0 0 0 0 0 R 1 1 0 1 0 R 1 1 0 1 0 T R R R R R R R R R R R T 1 1 0 1 0
0 1 0 R P 1 1 P 1 1 P 1 1 P 1 R P 1 0 1 0 R P 1 0 1 0 R P 1 0 1 1 1 1 0 R P 1 0 1 1 1 1 0 R P 1 0 1 0 R P 1 0 1 0 R P 1 1 P 1 1 P 1 1 P 1 R P 1 0 1 0
0 1 0 R 1 1 1 1 1 1 1 1 1 1 1 R 1 1 0 1 0 R 1 1 0 0 0 R 1 1 0 1 1 1 1 0 R 1 1 0 1 1 1 1 0 R 1 1 0 0 0 R 1 1 0 1 0 R 1 1 1 1 1 1 1 1 1 1 1 R 1 1 0 1 0
0 1 0 R 1 1 0 0 0 0 0 0 0 0 0 R 1 1 0 1 0 T R R R R R T 1 1 0 1 1 1 1 0 R 1 1 0 1 1 1 1 0 T R R R R R T 1 1 0 1 0 R 1 1 0 0 0 0 0 0 0 0 0 R 1 1 0 1 0
0 1 0 R P 1 0 1 1 1 1 1 1 1 0 R P 1 0 1 0 R P 1 1 P 1 R P 1 0 1 1 1 1 0 R P 1 0 1 1 1 1 0 R P 1 1 P 1 R P 1 0 1 0 R P 1 0 1 1 1 1 1 1 1 0 R P 1 0 1 0
0 1 0 R 1 1 0 0 0 0 0 0 0 1 0 R 1 1 0 1 0 R 1 1 1 1 1 R 1 1 0 1 1 1 1 0 R 1 1 0 1 1 1 1 0 R 1 1 1 1 1 R 1 1 0 1 0 R 1 1 0 1 0 0 0 0 0 0 0 R 1 1 0 1 0
0 1 0 T R R R R R T 1 1 0 1 0 R 1 1 0 1 0 R 1 1 0 0 0 R 1 1 0 1 1 1 1 0 R 1 1 0 1 1 1 1 0 R 1 1 0 0 0 R 1 1 0 1 0 R 1 1 0 1 0 T R R R R R T 1 1 0 1 0
0 1 0 R P 1 1 P 1 R P 1 0 1 0 R P 1 0 1 0 R P 1 0 1 0 R P 1 0 1 1 1 1 0 R P 1 0 1 1 1 1 0 R P 1 0 1 0 R P 1 0 1 0 R P 1 0 1 0 R P 1 1 P 1 R P 1 0 1 0
0 1 0 R 1 1 1 1 1 R 1 1 0 0 0 R 1 1 0 1 0 R 1 1 0 1 0 R 1 1 0 0 0 0 0 0 R 1 1 0 0 0 0 0 0 R 1 1 0 1 0 R 1 1 0 1 0 R 1 1 0 0 0 R 1 1 1 1 1 R 1 1 0 1 0
0 1 0 R 1 1 0 0 0 T R R R R R T 1 1 0 1 0 R 1 1 0 1 0 T R R R R R T R R T R R T R R R R R T 1 1 0 1 0 R 1 1 0 1 0 T R R R R R T 1 1 0 0 0 R 1 1 0 1 0
0 1 0 R P 1 0 1 0 R P 1 1 P 1 R P 1 0 1 0 R P 1 0 1 0 1 P 1 1 P 1 R P 1 1 W 1 R P 1 1 P 1 1 P 1 0 1 0 R P 1 0 1 0 R P 1 1 P 1 R P 1 0 1 0 R P 1 0 1 0
0 1 0 R 1 1 0 1 0 R 1 1 1 1 1 R 1 1 0 0 0 R 1 1 0 1 0 1 1 1 1 1 1 R 1 1 1 1 1 R 1 1 1 1 1 1 1 1 0 1 0 R 1 1 0 0 0 R 1 1 1 1 1 R 1 1 0 1 0 R 1 1 0 1 0
0 1 0 R 1 1 0 1 0 R 1 1 0 0 0 T R R R R R T 1 1 0 1 0 0 0 0 0 0 0 R 1 1 0 0 0 R 1 1 0 0 0 0 0 0 0 1 0 T R R R R R T 1 1 0 0 0 R 1 1 0 1 0 R 1 1 0 1 0
0 1 0 R P 1 0 1 0 R P 1 0 1 0 1 P 1 1 P 1 R P 1 0 1 1 1 1 1 1 1 0 R P 1 0 1 0 R P 1 0 1 1 1 1 1 1 1 0 R P 1 1 P 1 1 P 1 0 1 0 R P 1 0 1 0 R P 1 0 1 0
0 1 0 R 1 1 0 1 0 R 1 1 0 1 0 1 1 1 1 1 1 R 1 1 0 1 1 1 1 1 1 1 0 R 1 1 0 1 0 R 1 1 0 1 1 1 1 1 1 1 0 R 1 1 1 1 1 1 1 1 0 1 0 R 1 1 0 1 0 R 1 1 0 1 0
0 1 0 R 1 1 0 1 0 R 1 1 0 1 0 0 0 0 0 0 0 R 1 1 0 1 1 1 1 1 1 1 0 R 1 1 0 1 0 R 1 1 0 1 1 1 1 1 1 1 0 R 1 1 0 0 0 0 0 0 0 1 0 R 1 1 0 1 0 R 1 1 0 1 0
0 1 0 R P 1 0 1 0 R P 1 0 1 1 1 1 1 1 1 0 R P 1 0 1 1 1 1 1 1 1 0 R P 1 0 1 0 R P 1 0 1 1 1 1 1 1 1 0 R P 1 0 1 1 1 1 1 1 1 0 R P 1 0 1 0 R P 1 0 1 0
0 1 0 R 1 1 0 1 0 R 1 1 0 0 0 0 0 0 0 0 0 R 1 1 0 0 0 0 0 0 0 0 0 R 1 1 0 1 0 R 1 1 0 0 0 0 0 0 0 0 0 R 1 1 0 0 0 0 0 0 0 0 0 R 1 1 0 1 0 R 1 1 0 1 0
0 1 0 R 1 1 0 1 0 T R R R R R R R R R R R T R R T R R R R R R R R T 1 1 0 1 0 T R R R R R R R R T R R T R R R R R R R R R R R T 1 1 0 1 0 R 1 1 0 1 0
0 1 0 R P 1 0 1 0 1 P 1 1 P 1 1 P 1 1 P 1 1 P 1 R P 1 1 P 1 1 P 1 1 P 1 0 1 0 1 P 1 1 P 1 1 P 1 R P 1 1 P 1 1 P 1 1 P 1 1 P 1 1 P 1 0 1 0 R P 1 0 1 0
0 1 0 R 1 1 0 1 0 1 1 1 1 1 1 1 1 1 1 1 1 1 1 1 R 1 1 1 1 1 1 1 1 1 1 1 0 1 0 1 1 1 1 1 1 1 1 1 R 1 1 1 1 1 1 1 1 1 1 1 1 1 1 1 1 1 0 1 0 R 1 1 0 1 0
0 1 0 R 1 1 0 1 0 0 0 0 0 0 0 0 0 0 0 0 0 0 0 0 R 1 1 0 0 0 0 0 0 0 0 0 0 1 0 0 0 0 0 0 0 0 0 0 R 1 1 0 0 0 0 0 0 0 0 0 0 0 0 0 0 0 0 1 0 R 1 1 0 1 0
0 1 0 R P 1 0 1 1 1 1 1 1 1 1 1 1 1 1 1 1 1 1 0 R P 1 0 1 1 1 1 1 1 1 1 1 1 1 1 1 1 1 1 1 1 1 0 R P 1 0 1 1 1 1 1 1 1 1 1 1 1 1 1 1 1 1 0 R P 1 0 1 0
0 1 0 R 1 1 0 0 0 0 0 0 0 0 0 0 0 0 0 0 0 0 0 0 R 1 1 0 0 0 0 0 0 0 0 0 0 0 0 0 0 0 0 0 0 0 0 0 R 1 1 0 0 0 0 0 0 0 0 0 0 0 0 0 0 0 0 0 0 R 1 1 0 1 0
0 1 0 T R R R R R R R R R R R R R R R R R R R R T R R R R R R R R R R R R R R R R R R R R R R R T R R R R R R R R R R R R R R R R R R R R T 1 1 0 1 0
0 1 0 1 W 1 1 P 1 1 P 1 1 P 1 1 P 1 1 P 1 1 P 1 1 P 1 1 P 1 1 P 1 1 P 1 1 P 1 1 P 1 1 P 1 1 P 1 1 P 1 1 P 1 1 P 1 1 P 1 1 P 1 1 P 1 1 P 1 1 W 1 0 1 0
0 1 0 1 1 1 1 1 1 1 1 1 1 1 1 1 1 1 1 1 1 1 1 1 1 1 1 1 1 1 1 1 1 1 1 1 1 1 1 1 1 1 1 1 1 1 1 1 1 1 1 1 1 1 1 1 1 1 1 1 1 1 1 1 1 1 1 1 1 1 1 1 0 1 0
0 1 0 0 0 0 0 0 0 0 0 0 0 0 0 0 0 0 0 0 0 0 0 0 0 0 0 0 0 0 0 0 0 0 0 0 0 0 0 0 0 0 0 0 0 0 0 0 0 0 0 0 0 0 0 0 0 0 0 0 0 0 0 0 0 0 0 0 0 0 0 0 0 1 0
0 1 1 1 1 1 1 1 1 1 1 1 1 1 1 1 1 1 1 1 1 1 1 1 1 1 1 1 1 1 1 1 1 1 1 1 1 1 1 1 1 1 1 1 1 1 1 1 1 1 1 1 1 1 1 1 1 1 1 1 1 1 1 1 1 1 1 1 1 1 1 1 1 1 0
0 0 0 0 0 0 0 0 0 0 0 0 0 0 0 0 0 0 0 0 0 0 0 0 0 0 0 0 0 0 0 0 0 0 0 0 0 0 0 0 0 0 0 0 0 0 0 0 0 0 0 0 0 0 0 0 0 0 0 0 0 0 0 0 0 0 0 0 0 0 0 0 0 0 0
